>NC_000017.11:c7687490-7668421 TP53 [organism=Homo sapiens] [GeneID=7157] [chromosome=17]
CTCAAAAGTCTAGAGCCACCGTCCAGGGAGCAGGTAGCTGCTGGGCTCCGGGGACACTTTGCGTTCGGGC
TGGGAGCGTGCTTTCCACGACGGTGACACGCTTCCCTGGATTGGGTAAGCTCCTGACTGAACTTGATGAG
TCCTCTCTGAGTCACGGGCTCTCGGCTCCGTGTATTTTCAGCTCGGGAAAATCGCTGGGGCTGGGGGTGG
GGCAGTGGGGACTTAGCGAGTTTGGGGGTGAGTGGGATGGAAGCTTGGCTAGAGGGATCATCATAGGAGT
TGCATTGTTGGGAGACCTGGGTGTAGATGATGGGGATGTTAGGACCATCCGAACTCAAAGTTGAACGCCT
AGGCAGAGGAGTGGAGCTTTGGGGAACCTTGAGCCGGCCTAAAGCGTACTTCTTTGCACATCCACCCGGT
GCTGGGCGTAGGGAATCCCTGAAATAAAAGATGCACAAAGCATTGAGGTCTGAGACTTTTGGATCTCGAA
ACATTGAGAACTCATAGCTGTATATTTTAGAGCCCATGGCATCCTAGTGAAAACTGGGGCTCCATTCCGA
AATGATCATTTGGGGGTGATCCGGGGAGCCCAAGCTGCTAAGGTCCCACAACTTCCGGACCTTTGTCCTT
CCTGGAGCGATCTTTCCAGGCAGCCCCCGGCTCCGCTAGATGGAGAAAATCCAATTGAAGGCTGTCAGTC
GTGGAAGTGAGAAGTGCTAAACCAGGGGTTTGCCCGCCAGGCCGAGGAGGACCGTCGCAATCTGAGAGGC
CCGGCAGCCCTGTTATTGTTTGGCTCCACATTTACATTTCTGCCTCTTGCAGCAGCATTTCCGGTTTCTT
TTTGCCGGAGCAGCTCACTATTCACCCGATGAGAGGGGAGGAGAGAGAGAGAAAATGTCCTTTAGGCCGG
TTCCTCTTACTTGGCAGAGGGAGGCTGCTATTCTCCGCCTGCATTTCTTTTTCTGGATTACTTAGTTATG
GCCTTTGCAAAGGCAGGGGTATTTGTTTTGATGCAAACCTCAATCCCTCCCCTTCTTTGAATGGTGTGCC
CCACCCCGCGGGTCGCCTGCAACCTAGGCGGACGCTACCATGGCGTGAGACAGGGAGGGAAAGAAGTGTG
CAGAAGGCAAGCCCGGAGGTATTTTCAAGAATGAGTATATCTCATCTTCCCGGAGGAAAAAAAAAAAGAA
TGGGTACGTCTGAGAATCAAATTTTGAAAGAGTGCAATGATGGGTCGTTTGATAATTTGTCGGAAAAACA
ATCTACCTGTTATCTAGCTTTGGGCTAGGCCATTCCAGTTCCAGACGCAGGCTGAACGTCGTGAAGCGGA
AGGGGCGGGCCCGCAGGCGTCCGTGTGGTCCTCCGTGCAGCCCTCCGGCCCGAGCCGGTTCTTCCTGGTA
GGAGGCGGAACTCGAATTCATTTCTCCCGCTGCCCCATCTCTTAGCTCGCGGTTGTTTCATTCCGCAGTT
TCTTCCCATGCACCTGCCGCGTACCGGCCACTTTGTGCCGTACTTACGTCATCTTTTTCCTAAATCGAGG
TGGCATTTACACACAGCGCCAGTGCACACAGCAAGTGCACAGGAAGATGAGTTTTGGCCCCTAACCGCTC
CGTGATGCCTACCAAGTCACAGACCCTTTTCATCGTCCCAGAAACGTTTCATCACGTCTCTTCCCAGTCG
ATTCCCGACCCCACCTTTATTTTGATCTCCATAACCATTTTGCCTGTTGGAGAACTTCATATAGAATGGA
ATCAGGCTGGGCGCTGTGGCTCACGCCTGCACTTTGGGAGGCCGAGGCGGGCGGATTACTTGAGGATAGG
AGTTCCAGACCAGCGTGGCCAACGTGGTGAATCCCCGTCTCTACTAAAAAATACAAAAATTAGCTGGGCG
TGGTGGGTGCCTGTAATCCCAGCTATTCGGGAGGGTGAGGCAGGAGAATCGCTTGAACCCGGGAGGCAGA
GGTTGCAGTGAGCCAAGATCGTGCCACTACACTCCAGCCTGGGCGACAAGAACGAAACTCCGTCTCAAAA
AAAAGGGGGGAATCATACATTATGTGCTCATTTTTGTCGGGCTTCTGTCCTTCAATGTACTGTCTGACAT
TCGTTCATGTTGTATATATCAGTATTTTGCTCCTTTTCATTTAGTATAGTCCATCGATTGTATATCCGTC
CTTTTGATGGCCTTTTGAGTTGTTTCCCATTTGCGGTTATGAAATAAAGCTGCTATAAACATTCTTGTAC
AATTCTTTTTGTGATCATATGTTTTCGTGTTTCTTGGAGAAATACTTAGGAGGGGAATTGCGAGTTTGGA
AGTAAAAAGTAGCTGTATTTTGAACTTTTTCAGAAGCTCTGAGTTTTCCAGAGCGGTTGTACCATTTTAC
ACTCCAACTAGCAAGGTATGGGAGTTATTATGGTTGTGCCACAGCCTTCCGGACATTAGGTATTGTCAGT
CTTTCTAATGTGGTATATCCTTGTGGTTGTAATTTACAGTTCTCTATTGACTAAGGATGTTCAGCATTTT
TTCATGTGCCTATTGGCCATTCGTATTTTGTTTGTAAAGTAGCTCTTCGAGTCTTTTACCTGTTATTTTG
GTTTTTTGTTTGTTTTTATTGTTCAGTTGTGGGACTGCTTTATACATTCTGGATACAAGTCCTTTATCAG
ATCCATGTGTCGTGAATGTTTTCTTCTGATCTGTTGCTTGCCTATTTGTTTGCTTTACAGAGTTTACAGT
ATCTTAAGAGGAGTGGATTTATCTTTTTTATGTTCAGTATTTGCCTTGTCCTGTTTAGGACATCTTTTTT
TTTTTTTTTAACCCCAGGGTCATGAAGATATTATCTTACATTTTCTTTTAGGACCTTTATGGTTGTAAGT
TTTACAGTAAGGTCCTTGAGCCATTAATTAATTCTTAAAATTAATTGTTTATGGTGTGAGGTGTAGGAGT
CAGTCTCTGGTATCTTTCCTGTATGGAAATCCAGTTATTCTGTCTCCACTTGTTGAAATAGGCTTCCTTT
CTCTACTGAATGCTTTTAATTTTAATTATTTTACAGTTGGAGTATAGGGCTACCATTTTAGTGCTATTTT
CTTTTTTTCTTTGTTAATTTTTGAGACAGGGACTCACACTGTTGCCCAGGCTAGAGTACAATGGCACAAT
CAAGGCTTACTGCAGCCTCGAACCCCTGGGCTCAAGCAGTCCTCTAGCAGCCTCACGAGTAGCTGGGATT
ACTCCACCACACCCAGCTAACTATTTTATTTTTTTGTATTGACAGGATCTCACTATGTTGCCCAGGCTGG
TCTCAAACTGCTGGCCTCAAGCTTTCATCCCATCTCGGCCTCCCAAAGTGCTGGGATTACAGGTGTGAGC
CACCATGCCTGACCTCTTAGTGCTATTTTCTATTTATCTCCTCTGTTCTCTGCTCTCTTTAAACGTTGGA
GGAAGAAACAGTACCCATCTTACACAAACTCTTCAGAAAACAGAGGAACAGACTGGGCGCGGTGGCTCAT
ACCTGTAATCTCAGCACTTTGGTACGCTGAGGCAGGGGATCATTTGAGGTCGGGAGTTCGAGACCAGCCT
GGCCAACACGGCGAAACCCCATCTCTACTAAAAATACAAAAAGTAGCTAGGCGTGGTGACACATACCTGT
AATGCCAGTTACTCAGGAGGCTGAGGCACAAGAATCCCTTGAACCTGGGAAGCGGAGGTTGCAGTGAGCC
GAGATTGCGCCACTGCACTCCAGCCTGGGCAACAGAGTGAGACCCTGTCTCAGAAAAAAAAAGAAAGAAA
GAAAAAATAGAGGAATATTTCCCAACTTGTTTTCGAAGCCAGCATAATCCTGGTACCAAAACCAAACAAG
GACATTATAAGAAAAGAAAATATAGACCAATATTCCTGTTAGCATAGACATGCAACAGCTAACCAATTTT
AGCAAACCAAACCTGGTAATATAGAAAAAAGGATAAATAGGCCAGTCGCGGTGGCTCACGCCTGTAATCC
CAGCACTTTGGGAGGCTGAGGCAGGCAGATCACTTGAGGTCAGGAGTTTGAGACCAGCCTGACCAACATG
GTGAAACCCCGTTTCTAATAAAAATACAAAAATCAGGCTGGGCACGGTGGCTCACGCCTGTAATCCCAGC
ACTTTGGGAGGCCGAGGTGGGCAGATCACGAGGTCAGGAGTTCAAGACCAGCCTGACCAATGTGGTGAAA
CGCCATCTCTACTAAAAATACAAAAATCAGCCGGTGTGGTGGCACCTGCCTGTAATCCCAGCTACTCAGG
AGGCTGAGGCAGAATTGCTTGAACCCGGGAGGCAGAGGTTGCAGTGAGCCAAGATCGTGCCACTGCACTC
CAGCCTGGGCGACAGAGCAAGACTTCATCTCAAAAAAAAAAAAAAATTAGCTGGGCATGGTGGTGGGCAC
CTGAAATCCCAGCTACTCGGGAGTCTGAGGCAGGAGAATCGCTTGAACCCAGGAGGCAGAAGTTGCACTG
AGCTGGGATCACACCATTGCACTCCAGCCTGGGCAACAGAGTGAGACTCCATCTCAAAAAAAGAAAAAGA
AAAAGGATAAATACATTCTAACCAAATAATGTTTATCTCATGATTGTAGCTGATTCAACATTCAAAAATT
GGCCTGGTGCAGTAGCTCAGGCCTGTAATCCCAACATTTTAGGAGGCTGAGGCAGGAAGATCTCTTGAGC
CCAGGATTTCAAGACCAGCCTGGGCAACATAGTCAGACTGGTCTTTACTGGGGGGAAAAAAATCAGTCTG
TGTAATTCACCACATTAACAAAGGGAAACATAAAAACCCTATGATCATTTCAACAGATGTAGCAAAAGCA
GTTAATGATATTCAACACATATGCATGATTACAAACCAACCAACCTCCTAGCAAACTAGGGAAAGGAAAC
TTAACCTAGTTTGATAACAGGGCGTCCACAGTCGGAGTTCCACTAGCAGCATACATAATGGTAGAAAACT
CAGTGCTGCCGGGCGCGGTGGCTCACGCCTGTAATGCCAGCACTTTGGGAGGCCTAGGCGGGCGGATCAC
GAGGTCAGGAGATCGAGACTGTCCTGACTAGCATGCTGAAACCCCGTCTCTACTAAAAATACAAAAACAA
AAAATTAGCCGGGCATGGTGGCGGGCGCCTATAGTCCCAGCTACTCGGGAGGCTGAGGCGAGAGAATGGC
GTGAACCCGGGAGGCGGAGCTTGCAGAGCCTAGATCGTGCCACTGCACTCCAGCCTGGGTGACAGAGTGA
GACTTCGTCTCAAAAAAAAAAAAAAAAAAAAAAGAAAAGAAAACTCAACGCTTTTTCCTCTAAGATCAGG
AACTAGAAAAGGATTTGACTCTCACAACGTTGATACCATACTGGAGGTTTTAACCAGGCAAGAAAAAGAA
ATAATGAGGGCCGGGTGCGGTGGCTCAGGCCTGTAATCCCAGCACTTTGGGAAGCCGAGACGGGTGGATC
ACGAGGTCAGGAGATCGAGACCATCCTGGCTAACACGGTGAAACCCTGTCTCTACTAAATATACAAAAAA
TTAGCCGGGCGTAGTGGCGGGCGCCTGTAGTCCCAGCTACTCGGGAGGCTGAGGCAGGAGAATGGCGTGA
ACTCAGGGGGCGGAGCTTGCAGTGAGCTGAGATCGAGCCACTGCACTCCAGCCTGGGCGACAGAGCAAGA
CTGTGTCTCAAAAAAAAAAAAAGAAAAAGAAATAATGATTAGTGGCCCGATGTCTCACGCCTATAATCCC
AGCACTTTGGGAGGCCGAGGTGGGCAGATCACCTGAGGTCTGGAGTTGGAGACCAGCCTGACAAAGATGG
TGAAACCTCGTCTCTATTAAAATATTAAAAAAATAGCCAGGCGTTGGCCGGGTACAGTGGCTCATGCCTG
TAATCCCAGCACTTTGGGAGGCCGAGGTGGGTGGATCACCTGAGGTCAGGAGTTCAACACCAGCCTGGCC
AACATGGTGAAACCCCATCTCTACTAAAAATACAAAAATTAGCCGGGCGTAGTGGCGGGCGCCTGTAATC
CCAGCTACTTGGGAGGCTTAGGCAGGAGAATCGCTTGAACCTGGGAGGCGGAGGTTGTAGTGAGCCGAGA
TTGCACCATTGCACTCCAGCCTGGGTGACAAAAGCAAAAACTCCGTCTCAAAAAAAAAAGAATTAGCCAG
GGGTAGTGGTGAACGCCTGTAGTCCCAGCTACTCAGGAGGCAGAGGCAGGAGAATCACTTGAACCCAGGA
GGCAGAGGTTGCAGTGAGCCGAGATTGTCCCATTGCACTCCAGCCTAGGCGACAAGAGCAAAATTCCATG
TCAAAAAAAAAAAAAAAAAAGGAAAGAAAAAAAATAACGATTAGAAAGGAAGAAATAAAACACATTCACA
GCCAGTATGATTCTATACATACATGTCCTAATGGGGCCAGGCGTGGTGGCTCATGCCTGTAATCCTAGCA
CTTTTAGGAGGCTGAGGCAGGTGGCTTCCCTGGGACCAGCCTGGCCAACATGGTGAAACCCCAACTCTAA
TAAAAATACAAAAAATCAGCCAGGCGTGGTGACGGGCACCTCTAATCCCAGCTACTCAGGAGGCTGAGGC
AGGAGAATTGCTTGGACCTGGGAGGCAGAGGTTGCAGTGAGCCGAGATCGCGCTATTGCACTCCAGCCTG
GGCAACAAGAGTGAAACTCCGGCAGGGTGTGGTGGCTTACGCCTGTAATCCCAGCACTTCGGGAGGCTGA
GGCAGGCCGATCACCTGAGGTCAGGAGTTTGAGACCAACCTAACATGGTGAAACCCCGTCTCTACTAAAA
ATACAAGAATTAGCTGGGTGTAGTGGTGGGCGCCTGTAATCCCAGCTACTTGGGAGGCTGAGACAGAAGA
ATTGCTTGAACCCAGGAGGTGGAGGTTGCAGTGAGCTGAGATCATGCCATTGCACACCACGCCGGGCAAC
AGAGCGAGATTCCGTCTCAAAAAAAAAAAAAAAGAGTGAAACTCTATCTCAAAAAAAAAAAAAAGTCCTA
ATGGAAAATCCATAAAAAGCTACCAAAACTAATAAATAAATATAGCAGGGTTGCAGGTTACAGGGCAATA
TAGTTATCCCTCTATCTGTAGGGGCTTGGTTCTGGGACTCCTCACACACCAAACCCACAGATGTCTAAGT
CCCATATATAAGACGGTATAGTATTTGGATTTAACCTACACATATCCTCCCATATAGTTTAAATTATCTC
TAGATTACTTACATTACCCCCATACAATGAAAATGCTAATGTACATGCAAGTATGTATGTAAGTACTTGT
ACTATATTGTTTAGGGAATCACTGGACATATAGGCCTTCAAGACTGATACCAGCAGCCACTGTTAAGATT
CTGGTCAGGCCTGCCCCTGTTTGGGGTCTCAGTTGATCTCATTGCCTTCCCACCCAGCCAAGGGCACCTG
CATTTCTCTTGGCTCCCTGGCCATTTGGAAGGCCTAGTTCAGCCTGGCACATTTGTATCCTGGCCCACTG
ATGCTGGTACCCCTGGGAAGGTCCTGCTCTGAAAAACACGGAGATTTTAGTTGCTACTGAAGATTTGAGA
GATAAAGACAGGGAGACCTGTCTGTAGACCTGTGTCCCTCCAAGTGGGATTGAGACTTTGGGCCCCCCAT
TTCAGGACAGCACCTCCTGGCCTGTTGACTGAATAGATCCCTGAAGGAGGTGTACTTGCATTAATGGAGT
GGGGGTGGGAGCAGTACCACAGATCCGCACTAACAATCACACAGTTCTCTCTAGAATAATAATATAGAAC
AAGTGAAATAGAACAATTGCAGAAAGAGCTAACCTTTGTTGAGCTCTTACTGTGTGCCCAGCACTTTCCT
CAACTCTACATTTCCCATAATACACAGAGTACTAGGTAGGCCAGGCTTGGTGGCTCACGCCTGTAATCCC
AGCACTTTAGGAGGCCAAGGGGGGTGGATCACCTGAGGTCGGGAGTTCAAGACCAGCCTGACCAACATGG
TGAAACCCCGTCTCTACTAGAAGTACAAAATTAGCCAGGTGTGGTGGCACATGCTTGTAGTCCTAGCTAC
TCAGCAGGCTGAGGCAGGAGAATCATTTGAATCCGGGAGGAGGTTGCAGTAAGCGGAGATAGTGCCACTG
TACTCCAGCCTGGGCAATAAGAGCTGAGACTCCGTCTCAAAATAAAATAAAATAAAATAAAATAAAATAA
AATAAAATAAAAAAAGAAAAGAGCCTGCCATTAAAGGAGCTGTTTGGTAGGGGATGTTTTGTCAGTGCAA
ACAACAGAAAAGTGGGCTGGGCACAGTGGTTCATGCCTGTAATCCCAGCACTTTGGGAGGCCAAGGCGGG
CGGATCACCTGAAGTTGGGAGTTCAAGACCAGCCTGACCAATATGGAGAAACCCCGTCTCTACTAAAAAT
ACAAAATTAGCCGGGCGCAGTGGCGCATGCCTGTAATCCCAGCTACTCGGGAGGCTGAGGCAGGAGAATC
GCTTGAACCTGGGAGGCAGAGGTTGCGGTGAGCCGAGATCGCACCATTGCACTCCAGCCTGGACGAGAGC
AAAACTCTGTCTCAAAAAAAAAAAAAAACAGAAAAGTGTAACAAACACTTACAGTAGGCATGTTTCTTAG
CAAATCTGATGACAAATTTGGCATAAAGAAAGAGAGCATCCCTGAAAAAAAAAAAAAGAAAAAGAAAGAG
AGCATCCTGCCTGGGCAACATAGTGAAACCCTGCCTCTACAAAAAAACTCAAAAATTGGCCGGGTGCAGT
GGCTCACACCTGTAATCCCAGCACTTTGGGAGTCGGAGGCGGGAGGATCACCTGAGGTCAGGAGTTCGAA
ACCAGCCTGGCCAACATGGCAAAACCCCATCTCTACTAAAAATACAAAAAATTAATCAGGCGCATTGGTG
GGCGCCTGTAATCCCAGCTACTCAGGAAGTTGAGGCAAGAGGATCGCTTGAATCTGGGAGGTGGAGGTTA
CAGTGAGTCGAGATCACACCACTGCACTCTAGCCTGGGTGACAGGGCGAGACTCCGTCTCCAAAAAAAAA
AAGAAAAAGAAAAAGACTAAAAAATTAGCCAGGCAGGCCTCTGTGGTCCCAGCTACTTGGGAGGCTGAGG
CAGGAGAATCACTGAGCCCAGGAGTCCGAGGCTGTAGTGAGCCATGATTGCACCACTGTACCCTAGCTTG
GGCAACAAAGCAAGACCCTGCCTCAAAAGAAAAAAGAAAGAAAGAAAGAACATGGCGGGCCAGGCACAGT
GGCTCACACCTGTAATCCCAGCGCTTTGAGAGGCCGAGGCAGGTGGATCACAAGGTCAGGAGTTCCACAC
CAGCCTGGCCAACATGGTGAAACCCTGTCTCTACTAAAAATACAAAAAATCAGCCAGGCATGGTGGCAGG
GGCCTGTAATCCCAGCTACTCGGGAGGCTGAGGCAGGAGAATTGCTTGAAACCAGAAGGCAGAGGTTGCA
GTGAGCCTAGACTGCACCACTGCACTCCAGCCTGGGCGAAAAGAGCCAAACTCCATCTCAAAAAACAAAC
AAAAAAACAAAACAAAAGAAAACATGGCAAAGCCTTTGAAAGCTTGTCTGGGAGAAGGTGCGATGATAGT
TGCATAACTTCGTGCAAGATGCTGGTCCACACAGGGGCTGCCCCTTGCTCTTTCTCGCTCTCTTAACCTC
TCATATAACAGGCTTGTGTGTTATTCACATTTATTGAGCCCAAGCAGGTGCAAGGCATTGTGATCTAATA
CTTTGGTCAGCAAGACAACAAGATAGATCACTGCCCTGCCCTTAGGAAGTGTATATGCTATTAGAGGAAA
CAGATAAAATAAACAAGGAAAAGTATCAGACAATGTAAGTGCTATGAGAATGCAAATGAGGTGATGTGAA
TTAAAATAGGATGACTTAAAGTCTGCACGGGAAGGAGCCTACCCCCATGTTCCTGGCTAGCCAAGGAACC
ACCAGTTGATTAGCAGAGAAGGGCAGCCAGTCTAGCTAGAGCTTTTGGGGAAGAGGGAGTGGTTGTTAAG
AGATGAGATTAAAGAAGCCGAGACGGGCCATTCGTGAGGGGTTTGTAATGCAGGGCTGAGGAGTGTCCGA
AGAGAATGGGCAGGTGAGCGGTGAGACAGTTGTTCTTCCAGAAGCTTTGCAGTGAAAGGAATCAAAGAAA
TGGAGCCGTGTATCAGGTGGGGAAGGGTGGGGGCCAAGGGGGTGTCCTTCCCCATACAGAGATTGCAGGC
TGAGAATGACTATATCCTTGTTAACAGGAGGTGGGAGCAGGGCACGGTAGCTCACACCTGTAATCTTGGC
ACTTTAGGAGGCTGAGGCGGGCCGATCACCTGAAGTAAGGAGTTCGAGACCAGCCTGGCCAACATGCAAA
GCCCTGTCTCTACTAAAAATACAAAAATTAGCTGGGTGTGGTGGTACTCGCCTGTAATCCCAGCTACTCG
GGAGACTGAGGCAGGAGAATGGCTTGAACCCGGAAGGTAGAGGTTGCAGTGAGCTGAGATCATGCCACTG
TGCTCCAGCCTAGGTGACAGAGAGAGACTCCATCTCAAAAAAAAAAAAAAAATACAGGAAGGGAGTTGGG
AATAGGGTGCACATTTAGGAAGTCTTGGGGATTTAGTGGTGGGAAGGTTGGAAGTCCCTCTCTGATTGTC
TTTTCCTCAAAGAAGTGCATGGCTGGTGAGGGGTGGGGCAGGAGTGCTTGGGTTGTGGTGAAACATTGGA
AGAGAGAATGTGAAGCAGCCATTCTTTTCCTGCTCCACAGGAAGCCGAGCTGTCTCAGACACTGGCATGG
TGTTGGGGGAGGGGGTTCCTTCTCTGCAGGCCCAGGTGACCCAGGGTTGGAAGTGTCTCATGCTGGATCC
CCACTTTTCCTCTTGCAGCAGCCAGACTGCCTTCCGGGTCACTGCCATGGAGGAGCCGCAGTCAGATCCT
AGCGTCGAGCCCCCTCTGAGTCAGGAAACATTTTCAGACCTATGGAAACTGTGAGTGGATCCATTGGAAG
GGCAGGCCCACCACCCCCACCCCAACCCCAGCCCCCTAGCAGAGACCTGTGGGAAGCGAAAATTCCATGG
GACTGACTTTCTGCTCTTGTCTTTCAGACTTCCTGAAAACAACGTTCTGGTAAGGACAAGGGTTGGGCTG
GGGACCTGGAGGGCTGGGGACCTGGAGGGCTGGGGGGCTGGGGGGCTGAGGACCTGGTCCTCTGACTGCT
CTTTTCACCCATCTACAGTCCCCCTTGCCGTCCCAAGCAATGGATGATTTGATGCTGTCCCCGGACGATA
TTGAACAATGGTTCACTGAAGACCCAGGTCCAGATGAAGCTCCCAGAATGCCAGAGGCTGCTCCCCCCGT
GGCCCCTGCACCAGCAGCTCCTACACCGGCGGCCCCTGCACCAGCCCCCTCCTGGCCCCTGTCATCTTCT
GTCCCTTCCCAGAAAACCTACCAGGGCAGCTACGGTTTCCGTCTGGGCTTCTTGCATTCTGGGACAGCCA
AGTCTGTGACTTGCACGGTCAGTTGCCCTGAGGGGCTGGCTTCCATGAGACTTCAATGCCTGGCCGTATC
CCCCTGCATTTCTTTTGTTTGGAACTTTGGGATTCCTCTTCACCCTTTGGCTTCCTGTCAGTGTTTTTTT
ATAGTTTACCCACTTAATGTGTGATCTCTGACTCCTGTCCCAAAGTTGAATATTCCCCCCTTGAATTTGG
GCTTTTATCCATCCCATCACACCCTCAGCATCTCTCCTGGGGATGCAGAACTTTTCTTTTTCTTCATCCA
CGTGTATTCCTTGGCTTTTGAAAATAAGCTCCTGACCAGGCTTGGTGGCTCACACCTGCAATCCCAGCAC
TCTCAAAGAGGCCAAGGCAGGCAGATCACCTGAGCCCAGGAGTTCAAGACCAGCCTGGGTAACATGATGA
AACCTCGTCTCTACAAAAAAATACAAAAAATTAGCCAGGCATGGTGGTGCACACCTATAGTCCCAGCCAC
TTAGGAGGCTGAGGTGGGAAGATCACTTGAGGCCAGGAGATGGAGGCTGCAGTGAGCTGTGATCACACCA
CTGTGCTCCAGCCTGAGTGACAGAGCAAGACCCTATCTCAAAAAAAAAAAAAAAAAAGAAAAGCTCCTGA
GGTGTAGACGCCAACTCTCTCTAGCTCGCTAGTGGGTTGCAGGAGGTGCTTACGCATGTTTGTTTCTTTG
CTGCCGTCTTCCAGTTGCTTTATCTGTTCACTTGTGCCCTGACTTTCAACTCTGTCTCCTTCCTCTTCCT
ACAGTACTCCCCTGCCCTCAACAAGATGTTTTGCCAACTGGCCAAGACCTGCCCTGTGCAGCTGTGGGTT
GATTCCACACCCCCGCCCGGCACCCGCGTCCGCGCCATGGCCATCTACAAGCAGTCACAGCACATGACGG
AGGTTGTGAGGCGCTGCCCCCACCATGAGCGCTGCTCAGATAGCGATGGTGAGCAGCTGGGGCTGGAGAG
ACGACAGGGCTGGTTGCCCAGGGTCCCCAGGCCTCTGATTCCTCACTGATTGCTCTTAGGTCTGGCCCCT
CCTCAGCATCTTATCCGAGTGGAAGGAAATTTGCGTGTGGAGTATTTGGATGACAGAAACACTTTTCGAC
ATAGTGTGGTGGTGCCCTATGAGCCGCCTGAGGTCTGGTTTGCAACTGGGGTCTCTGGGAGGAGGGGTTA
AGGGTGGTTGTCAGTGGCCCTCCAGGTGAGCAGTAGGGGGGCTTTCTCCTGCTGCTTATTTGACCTCCCT
ATAACCCCATGAGATGTGCAAAGTAAATGGGTTTAACTATTGCACAGTTGAAAAAACTGAAGCTTACAGA
GGCTAAGGGCCTCCCCTGCTTGGCTGGGCGCAGTGGCTCATGCCTGTAATCCCAGCACTTTGGGAGGCCA
AGGCAGGCGGATCACGAGGTTGGGAGATCGAGACCATCCTGGCTAACGGTGAAACCCCGTCTCTACTGAA
AAATACAAAAAAAAATTAGCCGGGCGTGGTGCTGGGCACCTGTAGTCCCAGCTACTCGGGAGGCTGAGGA
AGGAGAATGGCGTGAACCTGGGCGGTGGAGCTTGCAGTGAGCTGAGATCACGCCACTGCACTCCAGCCTG
GGCGACAGAGCGAGATTCCATCTCAAAAAAAAAAAAAAAAGGCCTCCCCTGCTTGCCACAGGTCTCCCCA
AGGCGCACTGGCCTCATCTTGGGCCTGTGTTATCTCCTAGGTTGGCTCTGACTGTACCACCATCCACTAC
AACTACATGTGTAACAGTTCCTGCATGGGCGGCATGAACCGGAGGCCCATCCTCACCATCATCACACTGG
AAGACTCCAGGTCAGGAGCCACTTGCCACCCTGCACACTGGCCTGCTGTGCCCCAGCCTCTGCTTGCCTC
TGACCCCTGGGCCCACCTCTTACCGATTTCTTCCATACTACTACCCATCCACCTCTCATCACATCCCCGG
CGGGGAATCTCCTTACTGCTCCCACTCAGTTTTCTTTTCTCTGGCTTTGGGACCTCTTAACCTGTGGCTT
CTCCTCCACCTACCTGGAGCTGGAGCTTAGGCTCCAGAAAGGACAAGGGTGGTTGGGAGTAGATGGAGCC
TGGTTTTTTAAATGGGACAGGTAGGACCTGATTTCCTTACTGCCTCTTGCTTCTCTTTTCCTATCCTGAG
TAGTGGTAATCTACTGGGACGGAACAGCTTTGAGGTGCGTGTTTGTGCCTGTCCTGGGAGAGACCGGCGC
ACAGAGGAAGAGAATCTCCGCAAGAAAGGGGAGCCTCACCACGAGCTGCCCCCAGGGAGCACTAAGCGAG
GTAAGCAAGCAGGACAAGAAGCGGTGGAGGAGACCAAGGGTGCAGTTATGCCTCAGATTCACTTTTATCA
CCTTTCCTTGCCTCTTTCCTAGCACTGCCCAACAACACCAGCTCCTCTCCCCAGCCAAAGAAGAAACCAC
TGGATGGAGAATATTTCACCCTTCAGGTACTAAGTCTTGGGACCTCTTATCAAGTGGAAAGTTTCCAGTC
TAACACTCAAAATGCCGTTTTCTTCTTGACTGTTTTACCTGCAATTGGGGCATTTGCCATCAGGGGGCAG
TGATGCCTCAAAGACAATGGCTCCTGGTTGTAGCTAACTAACTTCAGAACACCAACTTATACCATAATAT
ATATTTTAAAGGACCAGACCAGCTTTCAAAAAGAAAATTGTTAAAGAGAGCATGAAAATGGTTCTATGAC
TTTGCCTGATACAGATGCTACTTGACTTACGATGGTGTTACTTCCTGATAAACTCGTCGTAAGTTGAAAA
TATTGTAAGTTGAAAATGGATTTAATACACCTAATCTAAGGAACATCATAGCTTAGCCTAGCCTGCTTTT
TTTTTTTTTTTTTTTGGAGACAGAGTCTCACTCTGTCACCCAGGCTGGAGTGCAGTGGCGGGATCTCGGC
TCACTGCAACCTCCGCCTTCTGGGTTCAAGCGATTCTCCTGCCTCAGCCCACTGAGTAGCTGGGATTACA
GGCACCTGCCCCGACGCCCAGCTAATTTTTTGTTATTTATTTATTTTTTTTTTTAGTAGAGATGAGGTTT
CACCATGTTGGCCAGGCTAGTCTCGAACTCCTGACCTTGTGATCTGCCTGCCTTGGCCTCCCAAAGTGCT
GGGATTACAGGCGTGAGCCACCGCACCCGGCCTGCCTAGCCTACTTTTATTTTATTTTTAATGGAGACAG
CATCTTGCTCTGTTGCCCAGGCTGGATTACAGTGATGTGATCATAGCTCATTATACCCTCCTGGGCTCAA
GCAATCCCCCTAACTCTGCCTCCCCAGTAGCTAGGACCACAGGCATACACCACCATACCCAGCTAATTTT
TAAAATTTTTTGTAGATAGATAGAGTCTCACTATGTTGCCCAGGCTGGTCTCTAGCCTACTTTTTTGAGA
CAAGGTCTTGCTCTGTCACCCAGGCTGGATAGAGTGCAGTAGTGCAGTCACAGCTCACTGCAGCCTCCAC
CTCCCAGGCTCCATCCATCCTCCCAGCTCAGCCTCCCAAGTTGCTTCAACTACAGGCCTGCACCACCATG
CCTGGCTAATTTTTATTTATTTATTTTTATTTTATTTTATTTTATTTTTTTGAGACTCAGTCTCACTCTG
TCGCCCAGGCTGGAGTGCAGTGGCATGATCTCGGCTCACTGCAACCTCTGCCTCCTGGGTTCAAGTGATT
CTCCTGCCTCAGCCTCCCGAATAGCTAGGACTACAAGCGCCTGCTACCACGCCCAGCTAATTTTTGTATT
TTTAGTAGAGACAGGGTTTCACCATGTTGGCCAGGCTGGTCTCGAACTTCTGACCATGTGATCCGCCCGC
CTCGGCCTCCCAAAGTGCTGGGATTACAGGTGTGAGCCACCACGCCCGGCTAATTTTTATTTATTTATTT
AAAGACAGAGTCTCACTCTGTCACTCAGGCTAGAGTGCAGTGGCACCATCTCAGCTCACTGCAGCCTTGA
CCTCCCTGGGCTCCGGTGATTTCACCCTCCCAAGTAGCTAGGACTACAGGCACATGCCACGACACCCAGC
TAATTTTTTATTTTCTGTGAAGTCAAGGTCTTGCTACGTTGCCCATGCTGGTATCAAACCCCTGGGCTCA
ATCAATCCTTCCACCTCAGCCTCCCCAAGTATTGGGGTTACAGGCATGAGCTACCACACTCAGCCCTAGC
CTACTTGAAACGTGTTCAGAGCATTTAAGTTACCCTACAGTTGGGCAAAGTCATCTAACACAAAGCCCTT
TTTATAGTAATAAAATGTTGTATATCTCATGTGATTTATTGAATATTGTTACTGAAAGTGAGAAACAGCA
TGGTTGCATGAAAGGAGGCACAGTCGAGCCAGGCACAGCCTGGGCGCAGAGCGAGACTCAAAAAAAGAAA
AGGCCAGGCGCACTGGCTCACGCCTGTAATCCCAGCATTTCGGGAGGCTGAGGCGGGTGGATCACCTGAG
GTCAGGAGTTCAAGACCAGCCTAGCCAACATGGTGAAACCCCGTCTCTACTAAAATACAAAAATTAACCG
GGCGTGATGGCAGGTGCCTGTAATCCCAGCTACTTGGGAGGCTGAGGCAGGAGAATCGCTTGAACCAGGA
GGCGGAGGTTGCAGGGAGCCAAGATGGCGCCACTGCACTCCAGCCTGGGCGATAGAGTGAGACTCCGTCT
CAGAAAAAAAAGAAAAGAAACGAGGCACAGTCGCATGCACATGTAGTCCCAGTTACTTGAGAGGCTAAGG
CAGGAGGATCTCTTGAGCCCAAGAGTTTGAGTCCAGCCTGAACAACATAGCAAGACATCATCTCTAAAAT
TTAAAAAAGGGCCGGGCACAGTGGCTCACACCTGTAATCCCAGCACTTTGGGAGGTGGAGGTGGGTAGAT
CACCTGACGTCAGGAGTTGGAAACCAGCCTGGCTAACATGGTGAAGCCCCATCTCTACTAAAAACACAAA
AATTAGCCAGGTGTGGTAGCACACGCCTGTAGTCCCAGCTACTCGGGAGGCTGAGGCACAAGAATCACTT
GAACCCCAGAGGCGGAGATTGCAATCAGCCAAGATTGCACCATTGCACTCCCGCCTGGGCAACAGAGTGA
GACCCCATCTCAAAATAAATAAATAAATATTTTTAAAAGTCAGCTGTATAGGTACTTGAAGTGCAGTTTC
TACTAAATGCATGTTGCTTTTGTACCGTCATAAAGTCAAACAATTGTAACTTGAACCATCTTTTAACTCA
GGTACTGTGTATATACTTACTTCTCCCCCTCCTCTGTTGCTGCAGATCCGTGGGCGTGAGCGCTTCGAGA
TGTTCCGAGAGCTGAATGAGGCCTTGGAACTCAAGGATGCCCAGGCTGGGAAGGAGCCAGGGGGGAGCAG
GGCTCACTCCAGGTGAGTGACCTCAGCCCCTTCCTGGCCCTACTCCCCTGCCTTCCTAGGTTGGAAAGCC
ATAGGATTCCATTCTCATCCTGCCTTCATGGTCAAAGGCAGCTGACCCCATCTCATTGGGTCCCAGCCCT
GCACAGACATTTTTTTAGTCTTCCTCCGGTTGAATCCTATAACCACATTCTTGCCTCAGTGTATCCACAG
AACATCCAAACCCAGGGACGAGTGTGGATACTTCTTTGCCATTCTCCGCAACTCCCAGCCCAGAGCTGGA
GGGTCTCAAGGAGGGGCCTAATAATTGTGTAATACTGAATACAGCCAGAGTTTCAGGTCATATACTCAGC
CCTGCCATGCACCGGCAGGTCCTAGGTGACCCCCGTCAAACTCAGTTTCCTTATATATAAAATGGGGTAA
GGGGGCCGGGCGCAGTGGCTCACGAATCCCACACTCTGGGAGGCCAAGGCGAGTGGATCACCTGAGGTCG
GGAGTTTGAGCCCAGCCTGACCAACATGGAGAAACCCCATCTCTACTAAAAATACAAAAGTAGCCGGGCG
TGGTGATGCATGCCTGTAATCCCAGCTACCTACTCGGGAGGCTGAGGCAGGAGAATCGCTTGAACCCGGG
AGGCAGAGGTTGCGGTGAGCTGAGATCTCACCATTACACTCCAGCCTGGGCAACAAGAGTGAAACTCCGT
CTCAAAAAAGATAAATAAAGTAAAATGGGGTAAGGGAAGATTACGAGACTAATACACACTAATACTCTGA
GGTGCTCAGTAAACATATTTGCATGGGGTGTGGCCACCATCTTGATTTGAATTCCCGTTGTCCCAGCCTT
AGGCCCTTCAAAGCATTGGTCAGGGAAAAGGGGCACAGACCCTCTCACTCATGTGATGTCATCTCTCCTC
CCTGCTTCTGTCTCCTACAGCCACCTGAAGTCCAAAAAGGGTCAGTCTACCTCCCGCCATAAAAAACTCA
TGTTCAAGACAGAAGGGCCTGACTCAGACTGACATTCTCCACTTCTTGTTCCCCACTGACAGCCTCCCAC
CCCCATCTCTCCCTCCCCTGCCATTTTGGGTTTTGGGTCTTTGAACCCTTGCTTGCAATAGGTGTGCGTC
AGAAGCACCCAGGACTTCCATTTGCTTTGTCCCGGGGCTCCACTGAACAAGTTGGCCTGCACTGGTGTTT
TGTTGTGGGGAGGAGGATGGGGAGTAGGACATACCAGCTTAGATTTTAAGGTTTTTACTGTGAGGGATGT
TTGGGAGATGTAAGAAATGTTCTTGCAGTTAAGGGTTAGTTTACAATCAGCCACATTCTAGGTAGGGGCC
CACTTCACCGTACTAACCAGGGAAGCTGTCCCTCACTGTTGAATTTTCTCTAACTTCAAGGCCCATATCT
GTGAAATGCTGGCATTTGCACCTACCTCACAGAGTGCATTGTGAGGGTTAATGAAATAATGTACATCTGG
CCTTGAAACCACCTTTTATTACATGGGGTCTAGAACTTGACCCCCTTGAGGGTGCTTGTTCCCTCTCCCT
GTTGGTCGGTGGGTTGGTAGTTTCTACAGTTGGGCAGCTGGTTAGGTAGAGGGAGTTGTCAAGTCTCTGC
TGGCCCAGCCAAACCCTGTCTGACAACCTCTTGGTGAACCTTAGTACCTAAAAGGAAATCTCACCCCATC
CCACACCCTGGAGGATTTCATCTCTTGTATATGATGATCTGGATCCACCAAGACTTGTTTTATGCTCAGG
GTCAATTTCTTTTTTCTTTTTTTTTTTTTTTTTTCTTTTTCTTTGAGACTGGGTCTCGCTTTGTTGCCCA
GGCTGGAGTGGAGTGGCGTGATCTTGGCTTACTGCAGCCTTTGCCTCCCCGGCTCGAGCAGTCCTGCCTC
AGCCTCCGGAGTAGCTGGGACCACAGGTTCATGCCACCATGGCCAGCCAACTTTTGCATGTTTTGTAGAG
ATGGGGTCTCACAGTGTTGCCCAGGCTGGTCTCAAACTCCTGGGCTCAGGCGATCCACCTGTCTCAGCCT
CCCAGAGTGCTGGGATTACAATTGTGAGCCACCACGTCCAGCTGGAAGGGTCAACATCTTTTACATTCTG
CAAGCACATCTGCATTTTCACCCCACCCTTCCCCTCCTTCTCCCTTTTTATATCCCATTTTTATATCGAT
CTCTTATTTTACAATAAAACTTTGCTGCCATAAATTGCAG TAGCTTGAGGTTAACATTTAGACTTGGAACAATGCTAAAGGAAAGCATTTGGCAATATTTATTATAATTTAATTTTATATAAAAATATTTAATTTCCTCTGGATAGTCAAACCTGCCAGATATCAAACCTGAGGAAGGCAGAAGTGAATT
TGGAGAACTAGGGTAGAGAGAGGTTGCTATAAAACGAGCATTTGGAGGGCCCACGGCTTCACTCAGGACCTGCTGGGCTT
GTGTACCCCAGGAGCCCTTTTAAGTATCTTTTGTACGCTTTTCACCCCACCCCCAAGTCCTGGGAGAAATGCAGGCAACA
CTGAGACATGGGAGAGGCCAA